##############
#.....~~~~...#
#.....~~~~...#
#....######..#
#....#....#..#
#.........#..#
##############
